A#### ###  ## #### #### #
  ##   ##   ####  #######
#    #    # ###  #####  #
#### ######        ######
#### ##B####### ###  ##  
##    # ### ### ## #   # 
### # #              #